11111111111
1EE0CP00001
11111111111