11111111111
1E0CP0P0001
11111111111