1111111111111111111111111111111111111111
100001000100FCF0001C00000F01000000000001
1C0P010001000000001111110C01000111110001
1000010CF00F0111111C000000010F0001F00001
10000100001000000000000011110000010E0F01
10000F0000111111111111100001000001000001
10000000001000F0F01000000001000001111111
11111111111000C000100000000000C001000001
1000000F000000F00000000000000000010000C1
1000C00000001111111111111111111111001001
10000F0F00000000F00000C00000000001001001
1111111110000001111111111100000001001001
10C0000010000001000001000000000001001001
1001000010000000000001000000100001001001
100100001000111111000100F000100001001001
1001001000000000000001000000100000001001
100100100000000C000001000000100011111001
100100111111111111000F00100010000F001001
1001C010000C0000000000001000111110000001
1C010010000000F0000000001000100C00000001
1111111111111111111111111111111111111111