11111111111
1FC10P00001
1000000FCF1
100011E0001
11111111111