1111111111111111111111111111111111111111
1000010001000C00001C00000001000000000001
1C0P010001000000001111110C01000111110001
1000010C00000111111C00000001000001000001
10000100001000000000000011110000010E0001
1000000000111111111111100001000001000001
1000000000100000001000000001000001111111
11111111111000C000100000000000C001000001
10000000000000000000000000000000010000C1
1000C00000001111111111111111111111001001
1000000000000000000000C00000000001001001
1111111110000001111111111100000001001001
10C0000010000001000001000000000001001001
1001000010000000000001000000100001001001
1001000010001111110001000000100001001001
1001001000000000000001000000100000001001
100100100000000C000001000000100011111001
1001001111111111110000001000100000001001
1001C010000C0000000000001000111110000001
1C01001000000000000000001000100C00000001
1111111111111111111111111111111111111111