11111111111
1FC10000001
1000000FCF1
1P0011E0001
11111111111