1111111111111111111111111111111111
1E000000000000FC00F00C0000F0000001
10100101001000001010010000F0010101
1010010010101010001001000000010101
1P00F0000C00C0000000000000F00000C1
1111111111111111111111111111111111