11111111111
10010000001
10000000C01
1P0011E0001
11111111111