00000000000
1000EPC0001
11111111111
00111110111