111111111
10000FE0001
100P0C001
111111111