1111111
1T00001
1PECCF1
1111111