11111111111
100000000F1
100CC0000P1
100E0000001001
11111111111111